197 1573
events:
0 6941 50 1000 600 level1.level
1 2750 600 1050 150
1 6800 1150 50 50
enemies:
0 0 0
1 782 1590 450 650 10
1 6545 1288 450 650 5
2 4083 333 600 50 10
2 3790 1038 600 50 5
3 6545 1288 7
4 3012 1544 100 5
map:
TextMap0.texmap
0000000000000000000000000000000000000001111111111111111111111111111111111111111111000000000000000000000000000000000000000000000011111100000000000000000000000000
0000000000000000000000000000000000000001111111111111111111111111111111111111111111000000000000000000000000000000000000000000000011111100000000000000000000000000
0000000000000000000000000000000000000001111111111111111111111111111111111111111000000000000000000000000000000000000000000000000011111100000000000000000000000000
0000000000000000000000000000000000000001111111111111111111111111111111111000000000000000000000000000000000000000000000000000000011111100000000000000000000000000
0000000000000000000000000000000000000000111111000000000000000000000000000000000000000000000000000000000000000000000000000000000011111100000000000000000000000000
0000000000000000000000000000000000000000111111000000000000000000000000000000000000000000000000000000000000000000000000000000000011111100000000000000000000000000
0000000000000000000000000000000000000000111111000000000000000000000000000000000000000000000000000000000000000000000000000000000011111100000000000000000000000000
0000000000000000000000000000000000000000111111000000000000000000000000000000000000000000000000000000000000000000000000000000000011111100000000000000000000000000
0000000000000000000000000000000000000000011111000000000111111111111111111111111111111100000000001000000000000000000000000000000011111100000000000000000000000000
0000000000000000000000000000000000000000011111000011100111111111111111111111111111111000000000001000000000001000000000000000000011111100000000000000000000000000
0000000000000000000000000000000000000000011111000000000111111111111111111111111111111000001000001000000000001000000000000000000011111100000000000000000000000000
0000000000000000000000000000000000000000011111100000000111111111111111111111111111110000001000001000000000001000000000000000000011111100000000000000000000000000
0000000000000000000000000000000000000000011111100000000000000000000000000000001111100000001000001000001000001000000000000000000011111100000000000000000000000000
0000000000000000000000000000000000000000011111100000000000000000000000000000001111100000001000001000001000001000000111111111000011111100011111111111111111111111
0000000000000000000000000000000000000000011111100000000000000000000000000000001111100000001000001000001000001000000111111111000011111100011111111111111111111111
0000000000000000000000000000000000000000011111111000000111111111111111111111001111000000001000001000001000001000000111111111000011111101011111111111111111111111
0000000000000000000000000000000000000000001111111000000111111111111111111111001111000000001000001000001000001000000111111111000011111100011111111111111111111111
0000000000000000000000000000000000000000001111111000000111111111111111111111001111000000001000001000001000001000000111111111000011111100011111111111111111111111
0000000000000000000000000000000000000000001111111000000111111100000000000000001111000000001000001000001000001000000111111111000011111100011111111111111111111111
0000000000000000000000000000000000000000001111111000000111111100000000000000011111000000001000001000001000001000000111111111000000000001011111111111111111111000
0000000000000000000000000000000000000000001111111000000111111100000000000000011111000000001000001000001000001000000111111111000000000000011111111111111100000000
0000000000000000000000000000000000000000000111111000000111111100000000000000011111000000001000001000001000001000000111111111000000000000011111111111111000000000
0000000000000000000000000000000000000000000011110000000011111100011111111111111111000000001000001000001000001000000111111111000000000000011111111111111000000000
0000000000000000000000000000000000000000000000000000000001110000011111111111111111000000001000001000001000001000000111111111000000000000011111111111111000000000
0000000000000000000000000000000000000000000000000000000000000000001111111111111111000000001000001000001000001000000111111111000000000000011111111111110000000000
0000000000000000000000000000000000000000000000000000000000000000000011111111111110000000001000001000001000001000000111111111000000000000011111111111110000000000
0000000000000000000000000000000000000000000000000000000000000011000001111111111110000000001000001000001000001000000111111111000000000000011111111111110000000000
0000000000000000000000000000000000000000000000000000000000000000000000011111111100000000001000001000001000001000000111111111111111111111111111111111110000000000
0000000000000000000000000000000000000000000000000000000000000000000000011111111100000000001000001000001000001000000111111111111111111111111111111111100000000000
0000000000000000000000000000000000000000000000000000000000000000000000011111111000000000001000001000001000001000000111111111111111111111111111111111100000000000
0000000000000000000000000000000000000000000000000000000000000000000001111111110000000000001000001000001000001000000111111111111111111111111111111111100000000000
0000000000000000000000000000000000000000000000000000000000000000000001111111100000000000001000001000001000001000000111111111111111111111111111111111100000000000
0000000000000000000000000000000000000000000000000000000000001000111111111111100000000000001000001000001000001000000111111111111111111111111111111111100000000000
1111111111111111111111111111111110000011111111111111111110001000111111111111100000000000001000001000001000001000000111111111111111111111111111111111100000000000
1111111111111111111111111111111110000011111111111111111110001000111111111111000000000000001000001000001000001000000111111110000000000000000000000000000000000000
1111111111111111111111111111111110000011111111111111111110001000111111111110000000000000001000001000001000001000000111111110000000000000000000000000000000000000
1111111111111111111111111111111110000011111111111111111110001000111111111110000000000000001000001000001000001000000111111110000000000000000000000000000000000000
1111111111111111111111111111111110000011111111111111111110001000111111111110000000000000001000001000001000001000000111111110000000000000000000000000000000000000
1111111111111111111111111111111110000011111111111111111110001000111111111100000000000000001000001000001000001000000111111110000000000000000000000000000000000000
1111111111111111111111111111111110000011111111111111111110001000111111111100000000000000001000001000001000001000000111111110000000000000000000000000000000000000
1111111111111111111111111111111110000011111111111111111110001000111111111100000000000000001000001000001000001000000111111110000000000000000000000000000000000000
1111111111111111111111111111111110000011111111111111111110001000111111111100000000000000001000001000001000001000000111111110000000000000000000000000000000000000
1111111111111111111111111111111110000011111111111111111110001000111111111100000000000000001000001000001000001000000111111110000000000000000000000000000000000000
1111111111111111111111111111111110000011111111111111111110001000111111111100000000000000001000001000001000001000000111111110000000000000000000000000000000000000
1111111111111111111111111111111110000011111111111111111110001000111111111100000000000000001000001000001000001000000111111110000000000000000000000000000000000000
